0 0 0 200 2 200 0 2 10 
metall.bmp
0 0 200 0 200 2 0 2 10 
metall.bmp
200 0 200 200 198 200 198 0 10 
metall.bmp
0 200 200 200 200 198 0 198 10 
metall.bmp
20 20 30 20 30 30 20 30 10
resh.bmp
20 40 30 40 30 50 20 50 10
resh.bmp
20 60 30 60 30 70 20 70 10
resh.bmp
20 80 30 80 30 90 20 90 10
resh.bmp
20 100 30 100 30 110 20 110 10
resh.bmp
20 120 30 120 30 130 20 130 10
resh.bmp
20 140 30 140 30 150 20 150 10
resh.bmp
20 160 30 160 30 170 20 170 10
resh.bmp
20 180 30 180 30 190 20 190 10
resh.bmp
40 20 50 20 50 30 40 30 10
resh.bmp
40 40 50 40 50 50 40 50 10
resh.bmp
40 60 50 60 50 70 40 70 10
resh.bmp
40 80 50 80 50 90 40 90 10
resh.bmp
40 100 50 100 50 110 40 110 10
resh.bmp
40 120 50 120 50 130 40 130 10
resh.bmp
40 140 50 140 50 150 40 150 10
resh.bmp
40 160 50 160 50 170 40 170 10
resh.bmp
40 180 50 180 50 190 40 190 10
resh.bmp
60 20 70 20 70 30 60 30 10
resh.bmp
60 40 70 40 70 50 60 50 10
resh.bmp
60 60 70 60 70 70 60 70 10
resh.bmp
60 80 70 80 70 90 60 90 10
resh.bmp
60 100 70 100 70 110 60 110 10
resh.bmp
60 120 70 120 70 130 60 130 10
resh.bmp
60 140 70 140 70 150 60 150 10
resh.bmp
60 160 70 160 70 170 60 170 10
resh.bmp
60 180 70 180 70 190 60 190 10
resh.bmp
80 20 90 20 90 30 80 30 10
resh.bmp
80 40 90 40 90 50 80 50 10
resh.bmp
80 60 90 60 90 70 80 70 10
resh.bmp
80 80 90 80 90 90 80 90 10
resh.bmp
80 100 90 100 90 110 80 110 10
resh.bmp
80 120 90 120 90 130 80 130 10
resh.bmp
80 140 90 140 90 150 80 150 10
resh.bmp
80 160 90 160 90 170 80 170 10
resh.bmp
80 180 90 180 90 190 80 190 10
resh.bmp
100 20 110 20 110 30 100 30 10
resh.bmp
100 40 110 40 110 50 100 50 10
resh.bmp
100 60 110 60 110 70 100 70 10
resh.bmp
100 80 110 80 110 90 100 90 10
resh.bmp
100 100 110 100 110 110 100 110 10
resh.bmp
100 120 110 120 110 130 100 130 10
resh.bmp
100 140 110 140 110 150 100 150 10
resh.bmp
100 160 110 160 110 170 100 170 10
resh.bmp
100 180 110 180 110 190 100 190 10
resh.bmp
120 20 130 20 130 30 120 30 10
resh.bmp
120 40 130 40 130 50 120 50 10
resh.bmp
120 60 130 60 130 70 120 70 10
resh.bmp
120 80 130 80 130 90 120 90 10
resh.bmp
120 100 130 100 130 110 120 110 10
resh.bmp
120 120 130 120 130 130 120 130 10
resh.bmp
120 140 130 140 130 150 120 150 10
resh.bmp
120 160 130 160 130 170 120 170 10
resh.bmp
120 180 130 180 130 190 120 190 10
resh.bmp
140 20 150 20 150 30 140 30 10
resh.bmp
140 40 150 40 150 50 140 50 10
resh.bmp
140 60 150 60 150 70 140 70 10
resh.bmp
140 80 150 80 150 90 140 90 10
resh.bmp
140 100 150 100 150 110 140 110 10
resh.bmp
140 120 150 120 150 130 140 130 10
resh.bmp
140 140 150 140 150 150 140 150 10
resh.bmp
140 160 150 160 150 170 140 170 10
resh.bmp
140 180 150 180 150 190 140 190 10
resh.bmp
160 20 170 20 170 30 160 30 10
resh.bmp
160 40 170 40 170 50 160 50 10
resh.bmp
160 60 170 60 170 70 160 70 10
resh.bmp
160 80 170 80 170 90 160 90 10
resh.bmp
160 100 170 100 170 110 160 110 10
resh.bmp
160 120 170 120 170 130 160 130 10
resh.bmp
160 140 170 140 170 150 160 150 10
resh.bmp
160 160 170 160 170 170 160 170 10
resh.bmp
160 180 170 180 170 190 160 190 10
resh.bmp
180 20 190 20 190 30 180 30 10
resh.bmp
180 40 190 40 190 50 180 50 10
resh.bmp
180 60 190 60 190 70 180 70 10
resh.bmp
180 80 190 80 190 90 180 90 10
resh.bmp
180 100 190 100 190 110 180 110 10
resh.bmp
180 120 190 120 190 130 180 130 10
resh.bmp
180 140 190 140 190 150 180 150 10
resh.bmp
180 160 190 160 190 170 180 170 10
resh.bmp
180 180 190 180 190 190 180 190 10
resh.bmp