0 0 250 0 250 1 0 1 10 
wall.bmp
250 0 250 30 249 30 249 0 10 
wall.bmp
250 30 0 30 0 29 250 29 10
wall.bmp 
0 30 0 0 1 0 1 30 10
wall.bmp 
10 2 25 2 25 0 10 0 10 
picture_1.bmp
30 2 45 2 45 0 30 0 10 
picture_2.bmp
50 2 65 2 65 0 50 0 10 
picture_3.bmp
70 2 85 2 85 0 70 0 10 
picture_4.bmp
90 2 105 2 105 0 90 0 10 
picture_5.bmp
110 2 125 2 125 0 110 0 10 
picture_7.bmp
130 2 145 2 145 0 130 0 10 
picture_8.bmp
150 2 165 2 165 0 150 0 10 
picture_9.bmp
170 2 185 2 185 0 170 0 10 
picture_10.bmp
190 2 205 2 205 0 190 0 10 
picture_11.bmp
25 28 10 28 10 30 25 30 10 
picture_12.bmp
45 28 30 28 30 30 45 30 10 
picture_13.bmp
65 28 50 28 50 30 65 30 10 
picture_14.bmp
85 28 70 28 70 30 85 30 10 
picture_15.bmp
105 28 90 28 90 30 105 30 10 
picture_16.bmp
125 28 110 28 110 30 125 30 10 
picture_17.bmp
145 28 130 28 130 30 145 30 10 
picture_18.bmp
165 28 150 28 150 30 165 30 10 
picture_19.bmp
185 28 170 28 170 30 185 30 10 
picture_20.bmp
205 28 190 28 190 30 205 30 10 
picture_21.bmp