0 0 0 300 2 300 0 2 10 
rainbow.bmp
0 0 300 0 300 2 0 2 10 
rainbow.bmp
300 0 300 300 298 300 298 0 10 
rainbow.bmp
0 300 300 300 300 298 0 298 10 
rainbow.bmp
50 10 30 10 40 60 60 30 10
wood.bmp
290 290 290 260 260 290 270 270 10
wood.bmp
50 250 150 260 160 230 70 230 10
wood.bmp